14
XXXXXXXXXXXXXXX
X.........X...X
X.XXXXXXX.X.X.X
X.X.X.......X.X
X.XXX.XXXXXXX.X
X...........X.X
XXXXX.XXXXX.X.X
X.....X.X.X...X
X.XXX.XXXXX.XXX
X...X.........X
X.X.XXXXX.XXX.X
X.X.......X.X.X
X.XXXXX.X.XXX.X
X.......X.....X
XXXXXXXXXXXXXXX
